[ Layers : 93 ]
 { LayerName:s                         }
// -----------------------------------
   "APPLEORCHARD_GEN"                 
   "APPLEORCHARD_HIGH"                
   "APPLEORCHARD_LOW"                 
   "AUDIOEMITTERS"                    
   "BAGEND"                           
   "BAGEND_EXT_GEN"                   
   "BAGEND_EXT_HIGH"                  
   "BAGEND_EXT_LOW"                   
   "BAGEND_INSTANCES1"                
   "BAGEND_LIGHTS1"                   
   "BAGSHOT_GEN"                      
   "BAGSHOT_HIGH"                     
   "BAGSHOT_LOW"                      
   "BARNAREA_GEN"                     
   "BARNAREA_HIGH"                    
   "BARNAREA_LOW"                     
   "BRIDGEAREA_GEN"                   
   "BRIDGEAREA_HIGH"                  
   "BRIDGEAREA_LOW"                   
   "BRIDGE_FINAL"                     
   "BRIDGE_WORKAREA"                  
   "BROKENBRIDGE"                     
   "CH01_MUSIC"                       
   "CHESTS"                           
   "CHICKENS"                         
   "CINE02_BILBOLOSTPENNIES"          
   "CINE05_HOLMANMEANDERS"            
   "CINEMACONVERSATIONS"              
   "END_OF_LEVEL"                     
   "GREENDRAGONINN"                   
   "GREENDRAGON_GEN"                  
   "GREENDRAGON_HIGH"                 
   "GREENDRAGON_LOW"                  
   "GREENROOM"                        
   "H-TOWN_DESTRUCT"                  
   "HANNA_GEN"                        
   "HANNA_HIGH"                       
   "HANNA_LOW"                        
   "HAYSTACKS"                        
   "HOBBITS"                          
   "HOB_GLOBALSOBJECT"                
   "HOB_PLAYSURFACES"                 
   "HOLMANSHOUSE"                     
   "HTOWNCAMERAS"                     
   "HTOWNLIGHTS"                      
   "HTOWNMILLANI"                     
   "HTOWNPLAYGROUNDINST"              
   "HTOWNROCKS"                       
   "HTOWNTREES"                       
   "HTOWNTREES2"                      
   "HTOWN_APPLEORCHARD"               
   "HTOWN_BAGENDEXTERNAL_INSTANCES"   
   "HTOWN_BAGSHOTROW_INSTANCES"       
   "HTOWN_CHICKEN_COOP"               
   "HTOWN_CP"                         
   "HTOWN_DOGS"                       
   "HTOWN_FARM_INSTANCES"             
   "HTOWN_FENCES"                     
   "HTOWN_HANNAS_AREA"                
   "HTOWN_HOBBIT_KIDS"                
   "HTOWN_MILL_INSTANCES"             
   "HTOWN_MILL_IVY"                   
   "HTOWN_PICKUPS"                    
   "HTOWN_POND"                       
   "HTOWN_PROXYINSTANCES"             
   "HTOWN_SCARECROW"                  
   "HTOWN_SKYBOX"                     
   "HTOWN_SPICESTAND"                 
   "INBETWEEN_HIGH"                   
   "LOADTRIGGERS"                     
   "MIKENEWSTUFF"                     
   "MILL_AREA_GEN"                    
   "MILL_AREA_HIGH"                   
   "MILL_AREA_LOW"                    
   "MILL_POND_GEN"                    
   "MILL_POND_HIGH"                   
   "MILL_POND_LOW"                    
   "NAVNODES"                         
   "NAVPATHS"                         
   "NAVWALLS"                         
// -----------------------------------
// LayerName:s                        
// -----------------------------------
   "OLDMANGADLING"                    
   "OVERLAYVOLUMES"                   
   "PLAYGROUND_GEN"                   
   "PLAYGROUND_HIGH"                  
   "PLAYGROUND_LOW"                   
   "QUEST_PICK_UPS"                   
   "RIVER_ROCKS"                      
   "SAVE_PEDS"                        
   "SHED_CRUMBS"                      
   "SILVERPENNIES"                    
   "UPPERBAGEND"                      
   "WATERFALL_FX"                     
   "WELL_TRIGGER"                     
   
